"filename", "language", "Java", "YAML", "comment", "blank", "total"
"c:\Users\xiaoxiaoOWO\Desktop\yuehua\src\main\java\org\xiaoxiao\yuehua\Yuehua.java", "Java", 57, 0, 13, 25, 95
"c:\Users\xiaoxiaoOWO\Desktop\yuehua\src\main\java\org\xiaoxiao\yuehua\commands\Clearup.java", "Java", 53, 0, 3, 4, 60
"c:\Users\xiaoxiaoOWO\Desktop\yuehua\src\main\java\org\xiaoxiao\yuehua\data\DanData.java", "Java", 38, 0, 0, 10, 48
"c:\Users\xiaoxiaoOWO\Desktop\yuehua\src\main\java\org\xiaoxiao\yuehua\data\Data.java", "Java", 193, 0, 2, 52, 247
"c:\Users\xiaoxiaoOWO\Desktop\yuehua\src\main\java\org\xiaoxiao\yuehua\data\GongData.java", "Java", 38, 0, 0, 10, 48
"c:\Users\xiaoxiaoOWO\Desktop\yuehua\src\main\java\org\xiaoxiao\yuehua\data\ZhanData.java", "Java", 6, 0, 0, 2, 8
"c:\Users\xiaoxiaoOWO\Desktop\yuehua\src\main\java\org\xiaoxiao\yuehua\event\Spawner\Spawn.java", "Java", 21, 0, 4, 3, 28
"c:\Users\xiaoxiaoOWO\Desktop\yuehua\src\main\java\org\xiaoxiao\yuehua\event\entity\Breed.java", "Java", 10, 0, 0, 4, 14
"c:\Users\xiaoxiaoOWO\Desktop\yuehua\src\main\java\org\xiaoxiao\yuehua\event\entity\Death.java", "Java", 10, 0, 0, 3, 13
"c:\Users\xiaoxiaoOWO\Desktop\yuehua\src\main\java\org\xiaoxiao\yuehua\event\entity\PotionSpLash.java", "Java", 16, 0, 0, 3, 19
"c:\Users\xiaoxiaoOWO\Desktop\yuehua\src\main\java\org\xiaoxiao\yuehua\event\entity\SlimeSpilt.java", "Java", 10, 0, 0, 3, 13
"c:\Users\xiaoxiaoOWO\Desktop\yuehua\src\main\java\org\xiaoxiao\yuehua\event\entity\Transform.java", "Java", 10, 0, 0, 3, 13
"c:\Users\xiaoxiaoOWO\Desktop\yuehua\src\main\java\org\xiaoxiao\yuehua\event\player\Death.java", "Java", 53, 0, 1, 12, 66
"c:\Users\xiaoxiaoOWO\Desktop\yuehua\src\main\java\org\xiaoxiao\yuehua\event\player\Join.java", "Java", 39, 0, 13, 10, 62
"c:\Users\xiaoxiaoOWO\Desktop\yuehua\src\main\java\org\xiaoxiao\yuehua\event\player\Quit.java", "Java", 10, 0, 0, 3, 13
"c:\Users\xiaoxiaoOWO\Desktop\yuehua\src\main\java\org\xiaoxiao\yuehua\util\Damage.java", "Java", 24, 0, 6, 7, 37
"c:\Users\xiaoxiaoOWO\Desktop\yuehua\src\main\java\org\xiaoxiao\yuehua\util\GetEntity.java", "Java", 145, 0, 0, 46, 191
"c:\Users\xiaoxiaoOWO\Desktop\yuehua\src\main\java\org\xiaoxiao\yuehua\util\MySender.java", "Java", 121, 0, 0, 43, 164
"c:\Users\xiaoxiaoOWO\Desktop\yuehua\src\main\java\org\xiaoxiao\yuehua\util\Scores.java", "Java", 210, 0, 14, 62, 286
"c:\Users\xiaoxiaoOWO\Desktop\yuehua\src\main\resources\config.yml", "YAML", 0, 0, 0, 1, 1
"c:\Users\xiaoxiaoOWO\Desktop\yuehua\src\main\resources\plugin.yml", "YAML", 0, 8, 0, 1, 9
"Total", "-", 1064, 8, 56, 307, 1435