"filename", "language", "YAML", "Java", "comment", "blank", "total"
"c:\Users\xiaoxiaoOWO\Desktop\yuehua\src\main\java\org\xiaoxiao\yuehua\Yuehua.java", "Java", 0, 4, -1, -1, 2
"c:\Users\xiaoxiaoOWO\Desktop\yuehua\src\main\java\org\xiaoxiao\yuehua\commands\IntoGame.java", "Java", 0, 46, 1, 11, 58
"c:\Users\xiaoxiaoOWO\Desktop\yuehua\src\main\java\org\xiaoxiao\yuehua\commands\data\DataGet.java", "Java", 0, 28, 0, 4, 32
"c:\Users\xiaoxiaoOWO\Desktop\yuehua\src\main\java\org\xiaoxiao\yuehua\commands\data\DataSet.java", "Java", 0, 47, 0, 23, 70
"c:\Users\xiaoxiaoOWO\Desktop\yuehua\src\main\java\org\xiaoxiao\yuehua\data\DanData.java", "Java", 0, 3, 0, 1, 4
"c:\Users\xiaoxiaoOWO\Desktop\yuehua\src\main\java\org\xiaoxiao\yuehua\data\Data.java", "Java", 0, -1, 0, 2, 1
"c:\Users\xiaoxiaoOWO\Desktop\yuehua\src\main\java\org\xiaoxiao\yuehua\data\GongData.java", "Java", 0, 3, 0, 1, 4
"c:\Users\xiaoxiaoOWO\Desktop\yuehua\src\main\java\org\xiaoxiao\yuehua\event\entity\DamageByEntity.java", "Java", 0, 29, 1, 4, 34
"c:\Users\xiaoxiaoOWO\Desktop\yuehua\src\main\java\org\xiaoxiao\yuehua\event\player\Death.java", "Java", 0, -21, 0, -5, -26
"c:\Users\xiaoxiaoOWO\Desktop\yuehua\src\main\java\org\xiaoxiao\yuehua\event\player\Join.java", "Java", 0, 3, 0, 0, 3
"c:\Users\xiaoxiaoOWO\Desktop\yuehua\src\main\java\org\xiaoxiao\yuehua\util\Scores.java", "Java", 0, 53, 1, 16, 70
"c:\Users\xiaoxiaoOWO\Desktop\yuehua\src\main\resources\plugin.yml", "YAML", 6, 0, 0, 1, 7
"Total", "-", 6, 194, 2, 57, 259