"filename", "language", "YAML", "Java", "comment", "blank", "total"
"c:\Users\xiaoxiaoOWO\Desktop\yuehua\src\main\java\org\xiaoxiao\yuehua\Yuehua.java", "Java", 0, 61, 12, 24, 97
"c:\Users\xiaoxiaoOWO\Desktop\yuehua\src\main\java\org\xiaoxiao\yuehua\commands\Clearup.java", "Java", 0, 53, 3, 4, 60
"c:\Users\xiaoxiaoOWO\Desktop\yuehua\src\main\java\org\xiaoxiao\yuehua\commands\IntoGame.java", "Java", 0, 46, 1, 11, 58
"c:\Users\xiaoxiaoOWO\Desktop\yuehua\src\main\java\org\xiaoxiao\yuehua\commands\data\DataGet.java", "Java", 0, 28, 0, 4, 32
"c:\Users\xiaoxiaoOWO\Desktop\yuehua\src\main\java\org\xiaoxiao\yuehua\commands\data\DataSet.java", "Java", 0, 47, 0, 23, 70
"c:\Users\xiaoxiaoOWO\Desktop\yuehua\src\main\java\org\xiaoxiao\yuehua\data\DanData.java", "Java", 0, 41, 0, 11, 52
"c:\Users\xiaoxiaoOWO\Desktop\yuehua\src\main\java\org\xiaoxiao\yuehua\data\Data.java", "Java", 0, 192, 2, 54, 248
"c:\Users\xiaoxiaoOWO\Desktop\yuehua\src\main\java\org\xiaoxiao\yuehua\data\GongData.java", "Java", 0, 41, 0, 11, 52
"c:\Users\xiaoxiaoOWO\Desktop\yuehua\src\main\java\org\xiaoxiao\yuehua\data\ZhanData.java", "Java", 0, 6, 0, 2, 8
"c:\Users\xiaoxiaoOWO\Desktop\yuehua\src\main\java\org\xiaoxiao\yuehua\event\Spawner\Spawn.java", "Java", 0, 21, 4, 3, 28
"c:\Users\xiaoxiaoOWO\Desktop\yuehua\src\main\java\org\xiaoxiao\yuehua\event\entity\Breed.java", "Java", 0, 10, 0, 4, 14
"c:\Users\xiaoxiaoOWO\Desktop\yuehua\src\main\java\org\xiaoxiao\yuehua\event\entity\DamageByEntity.java", "Java", 0, 29, 1, 4, 34
"c:\Users\xiaoxiaoOWO\Desktop\yuehua\src\main\java\org\xiaoxiao\yuehua\event\entity\Death.java", "Java", 0, 10, 0, 3, 13
"c:\Users\xiaoxiaoOWO\Desktop\yuehua\src\main\java\org\xiaoxiao\yuehua\event\entity\PotionSpLash.java", "Java", 0, 16, 0, 3, 19
"c:\Users\xiaoxiaoOWO\Desktop\yuehua\src\main\java\org\xiaoxiao\yuehua\event\entity\SlimeSpilt.java", "Java", 0, 10, 0, 3, 13
"c:\Users\xiaoxiaoOWO\Desktop\yuehua\src\main\java\org\xiaoxiao\yuehua\event\entity\Transform.java", "Java", 0, 10, 0, 3, 13
"c:\Users\xiaoxiaoOWO\Desktop\yuehua\src\main\java\org\xiaoxiao\yuehua\event\player\Death.java", "Java", 0, 32, 1, 7, 40
"c:\Users\xiaoxiaoOWO\Desktop\yuehua\src\main\java\org\xiaoxiao\yuehua\event\player\Join.java", "Java", 0, 42, 13, 10, 65
"c:\Users\xiaoxiaoOWO\Desktop\yuehua\src\main\java\org\xiaoxiao\yuehua\event\player\Quit.java", "Java", 0, 10, 0, 3, 13
"c:\Users\xiaoxiaoOWO\Desktop\yuehua\src\main\java\org\xiaoxiao\yuehua\util\Damage.java", "Java", 0, 24, 6, 7, 37
"c:\Users\xiaoxiaoOWO\Desktop\yuehua\src\main\java\org\xiaoxiao\yuehua\util\GetEntity.java", "Java", 0, 145, 0, 46, 191
"c:\Users\xiaoxiaoOWO\Desktop\yuehua\src\main\java\org\xiaoxiao\yuehua\util\MySender.java", "Java", 0, 121, 0, 43, 164
"c:\Users\xiaoxiaoOWO\Desktop\yuehua\src\main\java\org\xiaoxiao\yuehua\util\Scores.java", "Java", 0, 263, 15, 78, 356
"c:\Users\xiaoxiaoOWO\Desktop\yuehua\src\main\resources\config.yml", "YAML", 0, 0, 0, 1, 1
"c:\Users\xiaoxiaoOWO\Desktop\yuehua\src\main\resources\plugin.yml", "YAML", 14, 0, 0, 2, 16
"Total", "-", 14, 1258, 58, 364, 1694